Jared	Ely	jared.ely@sakilacustomer.org	530
Mary	Smith	mary.smith@sakilacustomer.org	5
Patricia	Johnson	patricia.johnson@sakilacustomer.org	6
Linda	Williams	linda.williams@sakilacustomer.org	7
Barbara	Jones	barbara.jones@sakilacustomer.org	8
Elizabeth	Brown	elizabeth.brown@sakilacustomer.org	9
Jennifer	Davis	jennifer.davis@sakilacustomer.org	10
Maria	Miller	maria.miller@sakilacustomer.org	11
Susan	Wilson	susan.wilson@sakilacustomer.org	12
Margaret	Moore	margaret.moore@sakilacustomer.org	13
Dorothy	Taylor	dorothy.taylor@sakilacustomer.org	14
Lisa	Anderson	lisa.anderson@sakilacustomer.org	15
Nancy	Thomas	nancy.thomas@sakilacustomer.org	16
Karen	Jackson	karen.jackson@sakilacustomer.org	17
Betty	White	betty.white@sakilacustomer.org	18
Helen	Harris	helen.harris@sakilacustomer.org	19
Sandra	Martin	sandra.martin@sakilacustomer.org	20
Donna	Thompson	donna.thompson@sakilacustomer.org	21
Carol	Garcia	carol.garcia@sakilacustomer.org	22
Ruth	Martinez	ruth.martinez@sakilacustomer.org	23
Sharon	Robinson	sharon.robinson@sakilacustomer.org	24
Michelle	Clark	michelle.clark@sakilacustomer.org	25
Laura	Rodriguez	laura.rodriguez@sakilacustomer.org	26
Sarah	Lewis	sarah.lewis@sakilacustomer.org	27
Kimberly	Lee	kimberly.lee@sakilacustomer.org	28
Deborah	Walker	deborah.walker@sakilacustomer.org	29
Jessica	Hall	jessica.hall@sakilacustomer.org	30
Shirley	Allen	shirley.allen@sakilacustomer.org	31
Cynthia	Young	cynthia.young@sakilacustomer.org	32
Angela	Hernandez	angela.hernandez@sakilacustomer.org	33
Melissa	King	melissa.king@sakilacustomer.org	34
Brenda	Wright	brenda.wright@sakilacustomer.org	35
Amy	Lopez	amy.lopez@sakilacustomer.org	36
Anna	Hill	anna.hill@sakilacustomer.org	37
Rebecca	Scott	rebecca.scott@sakilacustomer.org	38
Virginia	Green	virginia.green@sakilacustomer.org	39
Kathleen	Adams	kathleen.adams@sakilacustomer.org	40
Pamela	Baker	pamela.baker@sakilacustomer.org	41
Martha	Gonzalez	martha.gonzalez@sakilacustomer.org	42
Debra	Nelson	debra.nelson@sakilacustomer.org	43
Amanda	Carter	amanda.carter@sakilacustomer.org	44
Stephanie	Mitchell	stephanie.mitchell@sakilacustomer.org	45
Carolyn	Perez	carolyn.perez@sakilacustomer.org	46
Christine	Roberts	christine.roberts@sakilacustomer.org	47
Marie	Turner	marie.turner@sakilacustomer.org	48
Janet	Phillips	janet.phillips@sakilacustomer.org	49
Catherine	Campbell	catherine.campbell@sakilacustomer.org	50
Frances	Parker	frances.parker@sakilacustomer.org	51
Ann	Evans	ann.evans@sakilacustomer.org	52
Joyce	Edwards	joyce.edwards@sakilacustomer.org	53
Diane	Collins	diane.collins@sakilacustomer.org	54
Alice	Stewart	alice.stewart@sakilacustomer.org	55
Julie	Sanchez	julie.sanchez@sakilacustomer.org	56
Heather	Morris	heather.morris@sakilacustomer.org	57
Teresa	Rogers	teresa.rogers@sakilacustomer.org	58
Doris	Reed	doris.reed@sakilacustomer.org	59
Gloria	Cook	gloria.cook@sakilacustomer.org	60
Evelyn	Morgan	evelyn.morgan@sakilacustomer.org	61
Jean	Bell	jean.bell@sakilacustomer.org	62
Cheryl	Murphy	cheryl.murphy@sakilacustomer.org	63
Mildred	Bailey	mildred.bailey@sakilacustomer.org	64
Katherine	Rivera	katherine.rivera@sakilacustomer.org	65
Joan	Cooper	joan.cooper@sakilacustomer.org	66
Ashley	Richardson	ashley.richardson@sakilacustomer.org	67
Judith	Cox	judith.cox@sakilacustomer.org	68
Rose	Howard	rose.howard@sakilacustomer.org	69
Janice	Ward	janice.ward@sakilacustomer.org	70
Kelly	Torres	kelly.torres@sakilacustomer.org	71
Nicole	Peterson	nicole.peterson@sakilacustomer.org	72
Judy	Gray	judy.gray@sakilacustomer.org	73
Christina	Ramirez	christina.ramirez@sakilacustomer.org	74
Kathy	James	kathy.james@sakilacustomer.org	75
Theresa	Watson	theresa.watson@sakilacustomer.org	76
Beverly	Brooks	beverly.brooks@sakilacustomer.org	77
Denise	Kelly	denise.kelly@sakilacustomer.org	78
Tammy	Sanders	tammy.sanders@sakilacustomer.org	79
Irene	Price	irene.price@sakilacustomer.org	80
Jane	Bennett	jane.bennett@sakilacustomer.org	81
Lori	Wood	lori.wood@sakilacustomer.org	82
Rachel	Barnes	rachel.barnes@sakilacustomer.org	83
Marilyn	Ross	marilyn.ross@sakilacustomer.org	84
Andrea	Henderson	andrea.henderson@sakilacustomer.org	85
Kathryn	Coleman	kathryn.coleman@sakilacustomer.org	86
Louise	Jenkins	louise.jenkins@sakilacustomer.org	87
Sara	Perry	sara.perry@sakilacustomer.org	88
Anne	Powell	anne.powell@sakilacustomer.org	89
Jacqueline	Long	jacqueline.long@sakilacustomer.org	90
Wanda	Patterson	wanda.patterson@sakilacustomer.org	91
Bonnie	Hughes	bonnie.hughes@sakilacustomer.org	92
Julia	Flores	julia.flores@sakilacustomer.org	93
Ruby	Washington	ruby.washington@sakilacustomer.org	94
Lois	Butler	lois.butler@sakilacustomer.org	95
Tina	Simmons	tina.simmons@sakilacustomer.org	96
Phyllis	Foster	phyllis.foster@sakilacustomer.org	97
Norma	Gonzales	norma.gonzales@sakilacustomer.org	98
Paula	Bryant	paula.bryant@sakilacustomer.org	99
Diana	Alexander	diana.alexander@sakilacustomer.org	100
Annie	Russell	annie.russell@sakilacustomer.org	101
Lillian	Griffin	lillian.griffin@sakilacustomer.org	102
Emily	Diaz	emily.diaz@sakilacustomer.org	103
Robin	Hayes	robin.hayes@sakilacustomer.org	104
Peggy	Myers	peggy.myers@sakilacustomer.org	105
Crystal	Ford	crystal.ford@sakilacustomer.org	106
Gladys	Hamilton	gladys.hamilton@sakilacustomer.org	107
Rita	Graham	rita.graham@sakilacustomer.org	108
Dawn	Sullivan	dawn.sullivan@sakilacustomer.org	109
Connie	Wallace	connie.wallace@sakilacustomer.org	110
Florence	Woods	florence.woods@sakilacustomer.org	111
Tracy	Cole	tracy.cole@sakilacustomer.org	112
Edna	West	edna.west@sakilacustomer.org	113
Tiffany	Jordan	tiffany.jordan@sakilacustomer.org	114
Carmen	Owens	carmen.owens@sakilacustomer.org	115
Rosa	Reynolds	rosa.reynolds@sakilacustomer.org	116
Cindy	Fisher	cindy.fisher@sakilacustomer.org	117
Grace	Ellis	grace.ellis@sakilacustomer.org	118
Wendy	Harrison	wendy.harrison@sakilacustomer.org	119
Victoria	Gibson	victoria.gibson@sakilacustomer.org	120
Edith	Mcdonald	edith.mcdonald@sakilacustomer.org	121
Kim	Cruz	kim.cruz@sakilacustomer.org	122
Sherry	Marshall	sherry.marshall@sakilacustomer.org	123
Sylvia	Ortiz	sylvia.ortiz@sakilacustomer.org	124
Josephine	Gomez	josephine.gomez@sakilacustomer.org	125
Thelma	Murray	thelma.murray@sakilacustomer.org	126
Shannon	Freeman	shannon.freeman@sakilacustomer.org	127
Sheila	Wells	sheila.wells@sakilacustomer.org	128
Ethel	Webb	ethel.webb@sakilacustomer.org	129
Ellen	Simpson	ellen.simpson@sakilacustomer.org	130
Elaine	Stevens	elaine.stevens@sakilacustomer.org	131
Marjorie	Tucker	marjorie.tucker@sakilacustomer.org	132
Carrie	Porter	carrie.porter@sakilacustomer.org	133
Charlotte	Hunter	charlotte.hunter@sakilacustomer.org	134
Monica	Hicks	monica.hicks@sakilacustomer.org	135
Esther	Crawford	esther.crawford@sakilacustomer.org	136
Pauline	Henry	pauline.henry@sakilacustomer.org	137
Emma	Boyd	emma.boyd@sakilacustomer.org	138
Juanita	Mason	juanita.mason@sakilacustomer.org	139
Anita	Morales	anita.morales@sakilacustomer.org	140
Rhonda	Kennedy	rhonda.kennedy@sakilacustomer.org	141
Hazel	Warren	hazel.warren@sakilacustomer.org	142
Amber	Dixon	amber.dixon@sakilacustomer.org	143
Eva	Ramos	eva.ramos@sakilacustomer.org	144
Debbie	Reyes	debbie.reyes@sakilacustomer.org	145
April	Burns	april.burns@sakilacustomer.org	146
Leslie	Gordon	leslie.gordon@sakilacustomer.org	147
Clara	Shaw	clara.shaw@sakilacustomer.org	148
Lucille	Holmes	lucille.holmes@sakilacustomer.org	149
Jamie	Rice	jamie.rice@sakilacustomer.org	150
Joanne	Robertson	joanne.robertson@sakilacustomer.org	151
Eleanor	Hunt	eleanor.hunt@sakilacustomer.org	152
Valerie	Black	valerie.black@sakilacustomer.org	153
Danielle	Daniels	danielle.daniels@sakilacustomer.org	154
Megan	Palmer	megan.palmer@sakilacustomer.org	155
Alicia	Mills	alicia.mills@sakilacustomer.org	156
Suzanne	Nichols	suzanne.nichols@sakilacustomer.org	157
Michele	Grant	michele.grant@sakilacustomer.org	158
Gail	Knight	gail.knight@sakilacustomer.org	159
Bertha	Ferguson	bertha.ferguson@sakilacustomer.org	160
Darlene	Rose	darlene.rose@sakilacustomer.org	161
Veronica	Stone	veronica.stone@sakilacustomer.org	162
Jill	Hawkins	jill.hawkins@sakilacustomer.org	163
Erin	Dunn	erin.dunn@sakilacustomer.org	164
Geraldine	Perkins	geraldine.perkins@sakilacustomer.org	165
Lauren	Hudson	lauren.hudson@sakilacustomer.org	166
Cathy	Spencer	cathy.spencer@sakilacustomer.org	167
Joann	Gardner	joann.gardner@sakilacustomer.org	168
Lorraine	Stephens	lorraine.stephens@sakilacustomer.org	169
Lynn	Payne	lynn.payne@sakilacustomer.org	170
Sally	Pierce	sally.pierce@sakilacustomer.org	171
Regina	Berry	regina.berry@sakilacustomer.org	172
Erica	Matthews	erica.matthews@sakilacustomer.org	173
Beatrice	Arnold	beatrice.arnold@sakilacustomer.org	174
Dolores	Wagner	dolores.wagner@sakilacustomer.org	175
Bernice	Willis	bernice.willis@sakilacustomer.org	176
Audrey	Ray	audrey.ray@sakilacustomer.org	177
Yvonne	Watkins	yvonne.watkins@sakilacustomer.org	178
Annette	Olson	annette.olson@sakilacustomer.org	179
June	Carroll	june.carroll@sakilacustomer.org	180
Samantha	Duncan	samantha.duncan@sakilacustomer.org	181
Marion	Snyder	marion.snyder@sakilacustomer.org	182
Dana	Hart	dana.hart@sakilacustomer.org	183
Stacy	Cunningham	stacy.cunningham@sakilacustomer.org	184
Ana	Bradley	ana.bradley@sakilacustomer.org	185
Renee	Lane	renee.lane@sakilacustomer.org	186
Ida	Andrews	ida.andrews@sakilacustomer.org	187
Vivian	Ruiz	vivian.ruiz@sakilacustomer.org	188
Roberta	Harper	roberta.harper@sakilacustomer.org	189
Holly	Fox	holly.fox@sakilacustomer.org	190
Brittany	Riley	brittany.riley@sakilacustomer.org	191
Melanie	Armstrong	melanie.armstrong@sakilacustomer.org	192
Loretta	Carpenter	loretta.carpenter@sakilacustomer.org	193
Yolanda	Weaver	yolanda.weaver@sakilacustomer.org	194
Jeanette	Greene	jeanette.greene@sakilacustomer.org	195
Laurie	Lawrence	laurie.lawrence@sakilacustomer.org	196
Katie	Elliott	katie.elliott@sakilacustomer.org	197
Kristen	Chavez	kristen.chavez@sakilacustomer.org	198
Vanessa	Sims	vanessa.sims@sakilacustomer.org	199
Alma	Austin	alma.austin@sakilacustomer.org	200
Sue	Peters	sue.peters@sakilacustomer.org	201
Elsie	Kelley	elsie.kelley@sakilacustomer.org	202
Beth	Franklin	beth.franklin@sakilacustomer.org	203
Jeanne	Lawson	jeanne.lawson@sakilacustomer.org	204
Vicki	Fields	vicki.fields@sakilacustomer.org	205
Carla	Gutierrez	carla.gutierrez@sakilacustomer.org	206
Tara	Ryan	tara.ryan@sakilacustomer.org	207
Rosemary	Schmidt	rosemary.schmidt@sakilacustomer.org	208
Eileen	Carr	eileen.carr@sakilacustomer.org	209
Terri	Vasquez	terri.vasquez@sakilacustomer.org	210
Gertrude	Castillo	gertrude.castillo@sakilacustomer.org	211
Lucy	Wheeler	lucy.wheeler@sakilacustomer.org	212
Tonya	Chapman	tonya.chapman@sakilacustomer.org	213
Ella	Oliver	ella.oliver@sakilacustomer.org	214
Stacey	Montgomery	stacey.montgomery@sakilacustomer.org	215
Wilma	Richards	wilma.richards@sakilacustomer.org	216
Gina	Williamson	gina.williamson@sakilacustomer.org	217
Kristin	Johnston	kristin.johnston@sakilacustomer.org	218
Jessie	Banks	jessie.banks@sakilacustomer.org	219
Natalie	Meyer	natalie.meyer@sakilacustomer.org	220
Agnes	Bishop	agnes.bishop@sakilacustomer.org	221
Vera	Mccoy	vera.mccoy@sakilacustomer.org	222
Willie	Howell	willie.howell@sakilacustomer.org	223
Charlene	Alvarez	charlene.alvarez@sakilacustomer.org	224
Bessie	Morrison	bessie.morrison@sakilacustomer.org	225
Delores	Hansen	delores.hansen@sakilacustomer.org	226
Melinda	Fernandez	melinda.fernandez@sakilacustomer.org	227
Pearl	Garza	pearl.garza@sakilacustomer.org	228
Arlene	Harvey	arlene.harvey@sakilacustomer.org	229
Maureen	Little	maureen.little@sakilacustomer.org	230
Colleen	Burton	colleen.burton@sakilacustomer.org	231
Allison	Stanley	allison.stanley@sakilacustomer.org	232
Tamara	Nguyen	tamara.nguyen@sakilacustomer.org	233
Joy	George	joy.george@sakilacustomer.org	234
Georgia	Jacobs	georgia.jacobs@sakilacustomer.org	235
Constance	Reid	constance.reid@sakilacustomer.org	236
Lillie	Kim	lillie.kim@sakilacustomer.org	237
Claudia	Fuller	claudia.fuller@sakilacustomer.org	238
Jackie	Lynch	jackie.lynch@sakilacustomer.org	239
Marcia	Dean	marcia.dean@sakilacustomer.org	240
Tanya	Gilbert	tanya.gilbert@sakilacustomer.org	241
Nellie	Garrett	nellie.garrett@sakilacustomer.org	242
Minnie	Romero	minnie.romero@sakilacustomer.org	243
Marlene	Welch	marlene.welch@sakilacustomer.org	244
Heidi	Larson	heidi.larson@sakilacustomer.org	245
Glenda	Frazier	glenda.frazier@sakilacustomer.org	246
Lydia	Burke	lydia.burke@sakilacustomer.org	247
Viola	Hanson	viola.hanson@sakilacustomer.org	248
Courtney	Day	courtney.day@sakilacustomer.org	249
Marian	Mendoza	marian.mendoza@sakilacustomer.org	250
Stella	Moreno	stella.moreno@sakilacustomer.org	251
Caroline	Bowman	caroline.bowman@sakilacustomer.org	252
Dora	Medina	dora.medina@sakilacustomer.org	253
Jo	Fowler	jo.fowler@sakilacustomer.org	254
Vickie	Brewer	vickie.brewer@sakilacustomer.org	255
Mattie	Hoffman	mattie.hoffman@sakilacustomer.org	256
Terry	Carlson	terry.carlson@sakilacustomer.org	258
Maxine	Silva	maxine.silva@sakilacustomer.org	259
Irma	Pearson	irma.pearson@sakilacustomer.org	260
Mabel	Holland	mabel.holland@sakilacustomer.org	261
Marsha	Douglas	marsha.douglas@sakilacustomer.org	262
Myrtle	Fleming	myrtle.fleming@sakilacustomer.org	263
Lena	Jensen	lena.jensen@sakilacustomer.org	264
Christy	Vargas	christy.vargas@sakilacustomer.org	265
Deanna	Byrd	deanna.byrd@sakilacustomer.org	266
Patsy	Davidson	patsy.davidson@sakilacustomer.org	267
Hilda	Hopkins	hilda.hopkins@sakilacustomer.org	268
Gwendolyn	May	gwendolyn.may@sakilacustomer.org	269
Jennie	Terry	jennie.terry@sakilacustomer.org	270
Nora	Herrera	nora.herrera@sakilacustomer.org	271
Margie	Wade	margie.wade@sakilacustomer.org	272
Nina	Soto	nina.soto@sakilacustomer.org	273
Cassandra	Walters	cassandra.walters@sakilacustomer.org	274
Leah	Curtis	leah.curtis@sakilacustomer.org	275
Penny	Neal	penny.neal@sakilacustomer.org	276
Kay	Caldwell	kay.caldwell@sakilacustomer.org	277
Priscilla	Lowe	priscilla.lowe@sakilacustomer.org	278
Naomi	Jennings	naomi.jennings@sakilacustomer.org	279
Carole	Barnett	carole.barnett@sakilacustomer.org	280
Brandy	Graves	brandy.graves@sakilacustomer.org	281
Olga	Jimenez	olga.jimenez@sakilacustomer.org	282
Billie	Horton	billie.horton@sakilacustomer.org	283
Dianne	Shelton	dianne.shelton@sakilacustomer.org	284
Tracey	Barrett	tracey.barrett@sakilacustomer.org	285
Leona	Obrien	leona.obrien@sakilacustomer.org	286
Jenny	Castro	jenny.castro@sakilacustomer.org	287
Felicia	Sutton	felicia.sutton@sakilacustomer.org	288
Sonia	Gregory	sonia.gregory@sakilacustomer.org	289
Miriam	Mckinney	miriam.mckinney@sakilacustomer.org	290
Velma	Lucas	velma.lucas@sakilacustomer.org	291
Becky	Miles	becky.miles@sakilacustomer.org	292
Bobbie	Craig	bobbie.craig@sakilacustomer.org	293
Violet	Rodriquez	violet.rodriquez@sakilacustomer.org	294
Kristina	Chambers	kristina.chambers@sakilacustomer.org	295
Toni	Holt	toni.holt@sakilacustomer.org	296
Misty	Lambert	misty.lambert@sakilacustomer.org	297
Mae	Fletcher	mae.fletcher@sakilacustomer.org	298
Shelly	Watts	shelly.watts@sakilacustomer.org	299
Daisy	Bates	daisy.bates@sakilacustomer.org	300
Ramona	Hale	ramona.hale@sakilacustomer.org	301
Sherri	Rhodes	sherri.rhodes@sakilacustomer.org	302
Erika	Pena	erika.pena@sakilacustomer.org	303
James	Gannon	james.gannon@sakilacustomer.org	304
John	Farnsworth	john.farnsworth@sakilacustomer.org	305
Robert	Baughman	robert.baughman@sakilacustomer.org	306
Michael	Silverman	michael.silverman@sakilacustomer.org	307
William	Satterfield	william.satterfield@sakilacustomer.org	308
David	Royal	david.royal@sakilacustomer.org	309
Richard	Mccrary	richard.mccrary@sakilacustomer.org	310
Charles	Kowalski	charles.kowalski@sakilacustomer.org	311
Joseph	Joy	joseph.joy@sakilacustomer.org	312
Thomas	Grigsby	thomas.grigsby@sakilacustomer.org	313
Christopher	Greco	christopher.greco@sakilacustomer.org	314
Daniel	Cabral	daniel.cabral@sakilacustomer.org	315
Paul	Trout	paul.trout@sakilacustomer.org	316
Mark	Rinehart	mark.rinehart@sakilacustomer.org	317
Donald	Mahon	donald.mahon@sakilacustomer.org	318
George	Linton	george.linton@sakilacustomer.org	319
Kenneth	Gooden	kenneth.gooden@sakilacustomer.org	320
Steven	Curley	steven.curley@sakilacustomer.org	321
Edward	Baugh	edward.baugh@sakilacustomer.org	322
Brian	Wyman	brian.wyman@sakilacustomer.org	323
Ronald	Weiner	ronald.weiner@sakilacustomer.org	324
Anthony	Schwab	anthony.schwab@sakilacustomer.org	325
Kevin	Schuler	kevin.schuler@sakilacustomer.org	326
Jason	Morrissey	jason.morrissey@sakilacustomer.org	327
Matthew	Mahan	matthew.mahan@sakilacustomer.org	328
Gary	Coy	gary.coy@sakilacustomer.org	329
Timothy	Bunn	timothy.bunn@sakilacustomer.org	330
Jose	Andrew	jose.andrew@sakilacustomer.org	331
Larry	Thrasher	larry.thrasher@sakilacustomer.org	332
Jeffrey	Spear	jeffrey.spear@sakilacustomer.org	333
Frank	Waggoner	frank.waggoner@sakilacustomer.org	334
Scott	Shelley	scott.shelley@sakilacustomer.org	335
Eric	Robert	eric.robert@sakilacustomer.org	336
Stephen	Qualls	stephen.qualls@sakilacustomer.org	337
Andrew	Purdy	andrew.purdy@sakilacustomer.org	338
Raymond	Mcwhorter	raymond.mcwhorter@sakilacustomer.org	339
Gregory	Mauldin	gregory.mauldin@sakilacustomer.org	340
Joshua	Mark	joshua.mark@sakilacustomer.org	341
Jerry	Jordon	jerry.jordon@sakilacustomer.org	342
Dennis	Gilman	dennis.gilman@sakilacustomer.org	343
Walter	Perryman	walter.perryman@sakilacustomer.org	344
Patrick	Newsom	patrick.newsom@sakilacustomer.org	345
Peter	Menard	peter.menard@sakilacustomer.org	346
Harold	Martino	harold.martino@sakilacustomer.org	347
Douglas	Graf	douglas.graf@sakilacustomer.org	348
Henry	Billingsley	henry.billingsley@sakilacustomer.org	349
Carl	Artis	carl.artis@sakilacustomer.org	350
Arthur	Simpkins	arthur.simpkins@sakilacustomer.org	351
Ryan	Salisbury	ryan.salisbury@sakilacustomer.org	352
Roger	Quintanilla	roger.quintanilla@sakilacustomer.org	353
Joe	Gilliland	joe.gilliland@sakilacustomer.org	354
Juan	Fraley	juan.fraley@sakilacustomer.org	355
Jack	Foust	jack.foust@sakilacustomer.org	356
Albert	Crouse	albert.crouse@sakilacustomer.org	357
Jonathan	Scarborough	jonathan.scarborough@sakilacustomer.org	358
Justin	Ngo	justin.ngo@sakilacustomer.org	359
Terry	Grissom	terry.grissom@sakilacustomer.org	360
Gerald	Fultz	gerald.fultz@sakilacustomer.org	361
Keith	Rico	keith.rico@sakilacustomer.org	362
Samuel	Marlow	samuel.marlow@sakilacustomer.org	363
Willie	Markham	willie.markham@sakilacustomer.org	364
Ralph	Madrigal	ralph.madrigal@sakilacustomer.org	365
Lawrence	Lawton	lawrence.lawton@sakilacustomer.org	366
Nicholas	Barfield	nicholas.barfield@sakilacustomer.org	367
Roy	Whiting	roy.whiting@sakilacustomer.org	368
Benjamin	Varney	benjamin.varney@sakilacustomer.org	369
Bruce	Schwarz	bruce.schwarz@sakilacustomer.org	370
Brandon	Huey	brandon.huey@sakilacustomer.org	371
Adam	Gooch	adam.gooch@sakilacustomer.org	372
Harry	Arce	harry.arce@sakilacustomer.org	373
Fred	Wheat	fred.wheat@sakilacustomer.org	374
Wayne	Truong	wayne.truong@sakilacustomer.org	375
Billy	Poulin	billy.poulin@sakilacustomer.org	376
Steve	Mackenzie	steve.mackenzie@sakilacustomer.org	377
Louis	Leone	louis.leone@sakilacustomer.org	378
Jeremy	Hurtado	jeremy.hurtado@sakilacustomer.org	379
Aaron	Selby	aaron.selby@sakilacustomer.org	380
Randy	Gaither	randy.gaither@sakilacustomer.org	381
Howard	Fortner	howard.fortner@sakilacustomer.org	382
Eugene	Culpepper	eugene.culpepper@sakilacustomer.org	383
Carlos	Coughlin	carlos.coughlin@sakilacustomer.org	384
Russell	Brinson	russell.brinson@sakilacustomer.org	385
Bobby	Boudreau	bobby.boudreau@sakilacustomer.org	386
Victor	Barkley	victor.barkley@sakilacustomer.org	387
Martin	Bales	martin.bales@sakilacustomer.org	388
Ernest	Stepp	ernest.stepp@sakilacustomer.org	389
Phillip	Holm	phillip.holm@sakilacustomer.org	390
Todd	Tan	todd.tan@sakilacustomer.org	391
Jesse	Schilling	jesse.schilling@sakilacustomer.org	392
Craig	Morrell	craig.morrell@sakilacustomer.org	393
Alan	Kahn	alan.kahn@sakilacustomer.org	394
Shawn	Heaton	shawn.heaton@sakilacustomer.org	395
Clarence	Gamez	clarence.gamez@sakilacustomer.org	396
Sean	Douglass	sean.douglass@sakilacustomer.org	397
Philip	Causey	philip.causey@sakilacustomer.org	398
Chris	Brothers	chris.brothers@sakilacustomer.org	399
Johnny	Turpin	johnny.turpin@sakilacustomer.org	400
Earl	Shanks	earl.shanks@sakilacustomer.org	401
Jimmy	Schrader	jimmy.schrader@sakilacustomer.org	402
Antonio	Meek	antonio.meek@sakilacustomer.org	403
Danny	Isom	danny.isom@sakilacustomer.org	404
Bryan	Hardison	bryan.hardison@sakilacustomer.org	405
Tony	Carranza	tony.carranza@sakilacustomer.org	406
Luis	Yanez	luis.yanez@sakilacustomer.org	407
Mike	Way	mike.way@sakilacustomer.org	408
Stanley	Scroggins	stanley.scroggins@sakilacustomer.org	409
Leonard	Schofield	leonard.schofield@sakilacustomer.org	410
Nathan	Runyon	nathan.runyon@sakilacustomer.org	411
Dale	Ratcliff	dale.ratcliff@sakilacustomer.org	412
Manuel	Murrell	manuel.murrell@sakilacustomer.org	413
Rodney	Moeller	rodney.moeller@sakilacustomer.org	414
Curtis	Irby	curtis.irby@sakilacustomer.org	415
Norman	Currier	norman.currier@sakilacustomer.org	416
Allen	Butterfield	allen.butterfield@sakilacustomer.org	417
Marvin	Yee	marvin.yee@sakilacustomer.org	418
Vincent	Ralston	vincent.ralston@sakilacustomer.org	419
Glenn	Pullen	glenn.pullen@sakilacustomer.org	420
Jeffery	Pinson	jeffery.pinson@sakilacustomer.org	421
Travis	Estep	travis.estep@sakilacustomer.org	422
Jeff	East	jeff.east@sakilacustomer.org	423
Chad	Carbone	chad.carbone@sakilacustomer.org	424
Jacob	Lance	jacob.lance@sakilacustomer.org	425
Lee	Hawks	lee.hawks@sakilacustomer.org	426
Melvin	Ellington	melvin.ellington@sakilacustomer.org	427
Alfred	Casillas	alfred.casillas@sakilacustomer.org	428
Kyle	Spurlock	kyle.spurlock@sakilacustomer.org	429
Francis	Sikes	francis.sikes@sakilacustomer.org	430
Bradley	Motley	bradley.motley@sakilacustomer.org	431
Jesus	Mccartney	jesus.mccartney@sakilacustomer.org	432
Herbert	Kruger	herbert.kruger@sakilacustomer.org	433
Frederick	Isbell	frederick.isbell@sakilacustomer.org	434
Ray	Houle	ray.houle@sakilacustomer.org	435
Joel	Francisco	joel.francisco@sakilacustomer.org	436
Edwin	Burk	edwin.burk@sakilacustomer.org	437
Don	Bone	don.bone@sakilacustomer.org	438
Eddie	Tomlin	eddie.tomlin@sakilacustomer.org	439
Ricky	Shelby	ricky.shelby@sakilacustomer.org	440
Troy	Quigley	troy.quigley@sakilacustomer.org	441
Randall	Neumann	randall.neumann@sakilacustomer.org	442
Barry	Lovelace	barry.lovelace@sakilacustomer.org	443
Alexander	Fennell	alexander.fennell@sakilacustomer.org	444
Bernard	Colby	bernard.colby@sakilacustomer.org	445
Mario	Cheatham	mario.cheatham@sakilacustomer.org	446
Leroy	Bustamante	leroy.bustamante@sakilacustomer.org	447
Francisco	Skidmore	francisco.skidmore@sakilacustomer.org	448
Marcus	Hidalgo	marcus.hidalgo@sakilacustomer.org	449
Micheal	Forman	micheal.forman@sakilacustomer.org	450
Theodore	Culp	theodore.culp@sakilacustomer.org	451
Clifford	Bowens	clifford.bowens@sakilacustomer.org	452
Miguel	Betancourt	miguel.betancourt@sakilacustomer.org	453
Oscar	Aquino	oscar.aquino@sakilacustomer.org	454
Jay	Robb	jay.robb@sakilacustomer.org	455
Jim	Rea	jim.rea@sakilacustomer.org	456
Tom	Milner	tom.milner@sakilacustomer.org	457
Calvin	Martel	calvin.martel@sakilacustomer.org	458
Alex	Gresham	alex.gresham@sakilacustomer.org	459
Jon	Wiles	jon.wiles@sakilacustomer.org	460
Ronnie	Ricketts	ronnie.ricketts@sakilacustomer.org	461
Bill	Gavin	bill.gavin@sakilacustomer.org	462
Lloyd	Dowd	lloyd.dowd@sakilacustomer.org	463
Tommy	Collazo	tommy.collazo@sakilacustomer.org	464
Leon	Bostic	leon.bostic@sakilacustomer.org	465
Derek	Blakely	derek.blakely@sakilacustomer.org	466
Warren	Sherrod	warren.sherrod@sakilacustomer.org	467
Darrell	Power	darrell.power@sakilacustomer.org	468
Jerome	Kenyon	jerome.kenyon@sakilacustomer.org	469
Floyd	Gandy	floyd.gandy@sakilacustomer.org	470
Leo	Ebert	leo.ebert@sakilacustomer.org	471
Alvin	Deloach	alvin.deloach@sakilacustomer.org	472
Tim	Cary	tim.cary@sakilacustomer.org	473
Wesley	Bull	wesley.bull@sakilacustomer.org	474
Gordon	Allard	gordon.allard@sakilacustomer.org	475
Dean	Sauer	dean.sauer@sakilacustomer.org	476
Greg	Robins	greg.robins@sakilacustomer.org	477
Jorge	Olivares	jorge.olivares@sakilacustomer.org	478
Dustin	Gillette	dustin.gillette@sakilacustomer.org	479
Pedro	Chestnut	pedro.chestnut@sakilacustomer.org	480
Derrick	Bourque	derrick.bourque@sakilacustomer.org	481
Dan	Paine	dan.paine@sakilacustomer.org	482
Lewis	Lyman	lewis.lyman@sakilacustomer.org	483
Zachary	Hite	zachary.hite@sakilacustomer.org	484
Corey	Hauser	corey.hauser@sakilacustomer.org	485
Herman	Devore	herman.devore@sakilacustomer.org	486
Maurice	Crawley	maurice.crawley@sakilacustomer.org	487
Vernon	Chapa	vernon.chapa@sakilacustomer.org	488
Roberto	Vu	roberto.vu@sakilacustomer.org	489
Clyde	Tobias	clyde.tobias@sakilacustomer.org	490
Glen	Talbert	glen.talbert@sakilacustomer.org	491
Hector	Poindexter	hector.poindexter@sakilacustomer.org	492
Shane	Millard	shane.millard@sakilacustomer.org	493
Ricardo	Meador	ricardo.meador@sakilacustomer.org	494
Sam	Mcduffie	sam.mcduffie@sakilacustomer.org	495
Rick	Mattox	rick.mattox@sakilacustomer.org	496
Lester	Kraus	lester.kraus@sakilacustomer.org	497
Brent	Harkins	brent.harkins@sakilacustomer.org	498
Ramon	Choate	ramon.choate@sakilacustomer.org	499
Charlie	Bess	charlie.bess@sakilacustomer.org	500
Tyler	Wren	tyler.wren@sakilacustomer.org	501
Gilbert	Sledge	gilbert.sledge@sakilacustomer.org	502
Gene	Sanborn	gene.sanborn@sakilacustomer.org	503
Marc	Outlaw	marc.outlaw@sakilacustomer.org	504
Reginald	Kinder	reginald.kinder@sakilacustomer.org	505
Ruben	Geary	ruben.geary@sakilacustomer.org	506
Brett	Cornwell	brett.cornwell@sakilacustomer.org	507
Angel	Barclay	angel.barclay@sakilacustomer.org	508
Nathaniel	Adam	nathaniel.adam@sakilacustomer.org	509
Rafael	Abney	rafael.abney@sakilacustomer.org	510
Leslie	Seward	leslie.seward@sakilacustomer.org	511
Edgar	Rhoads	edgar.rhoads@sakilacustomer.org	512
Milton	Howland	milton.howland@sakilacustomer.org	513
Raul	Fortier	raul.fortier@sakilacustomer.org	514
Ben	Easter	ben.easter@sakilacustomer.org	515
Chester	Benner	chester.benner@sakilacustomer.org	516
Cecil	Vines	cecil.vines@sakilacustomer.org	517
Duane	Tubbs	duane.tubbs@sakilacustomer.org	519
Franklin	Troutman	franklin.troutman@sakilacustomer.org	520
Andre	Rapp	andre.rapp@sakilacustomer.org	521
Elmer	Noe	elmer.noe@sakilacustomer.org	522
Brad	Mccurdy	brad.mccurdy@sakilacustomer.org	523
Gabriel	Harder	gabriel.harder@sakilacustomer.org	524
Ron	Deluca	ron.deluca@sakilacustomer.org	525
Mitchell	Westmoreland	mitchell.westmoreland@sakilacustomer.org	526
Roland	South	roland.south@sakilacustomer.org	527
Arnold	Havens	arnold.havens@sakilacustomer.org	528
Harvey	Guajardo	harvey.guajardo@sakilacustomer.org	529
Adrian	Clary	adrian.clary@sakilacustomer.org	531
Karl	Seal	karl.seal@sakilacustomer.org	532
Cory	Meehan	cory.meehan@sakilacustomer.org	533
Claude	Herzog	claude.herzog@sakilacustomer.org	534
Erik	Guillen	erik.guillen@sakilacustomer.org	535
Darryl	Ashcraft	darryl.ashcraft@sakilacustomer.org	536
Jamie	Waugh	jamie.waugh@sakilacustomer.org	537
Neil	Renner	neil.renner@sakilacustomer.org	538
Jessie	Milam	jessie.milam@sakilacustomer.org	539
Christian	Jung	christian.jung@sakilacustomer.org	540
Javier	Elrod	javier.elrod@sakilacustomer.org	541
Fernando	Churchill	fernando.churchill@sakilacustomer.org	542
Clinton	Buford	clinton.buford@sakilacustomer.org	543
Ted	Breaux	ted.breaux@sakilacustomer.org	544
Mathew	Bolin	mathew.bolin@sakilacustomer.org	545
Tyrone	Asher	tyrone.asher@sakilacustomer.org	546
Darren	Windham	darren.windham@sakilacustomer.org	547
Lonnie	Tirado	lonnie.tirado@sakilacustomer.org	548
Lance	Pemberton	lance.pemberton@sakilacustomer.org	549
Cody	Nolen	cody.nolen@sakilacustomer.org	550
Julio	Noland	julio.noland@sakilacustomer.org	551
Kelly	Knott	kelly.knott@sakilacustomer.org	552
Kurt	Emmons	kurt.emmons@sakilacustomer.org	553
Allan	Cornish	allan.cornish@sakilacustomer.org	554
Nelson	Christenson	nelson.christenson@sakilacustomer.org	555
Guy	Brownlee	guy.brownlee@sakilacustomer.org	556
Clayton	Barbee	clayton.barbee@sakilacustomer.org	557
Hugh	Waldrop	hugh.waldrop@sakilacustomer.org	558
Max	Pitt	max.pitt@sakilacustomer.org	559
Dwayne	Olvera	dwayne.olvera@sakilacustomer.org	560
Dwight	Lombardi	dwight.lombardi@sakilacustomer.org	561
Armando	Gruber	armando.gruber@sakilacustomer.org	562
Felix	Gaffney	felix.gaffney@sakilacustomer.org	563
Jimmie	Eggleston	jimmie.eggleston@sakilacustomer.org	564
Everett	Banda	everett.banda@sakilacustomer.org	565
Jordan	Archuleta	jordan.archuleta@sakilacustomer.org	566
Ian	Still	ian.still@sakilacustomer.org	567
Wallace	Slone	wallace.slone@sakilacustomer.org	568
Ken	Prewitt	ken.prewitt@sakilacustomer.org	569
Bob	Pfeiffer	bob.pfeiffer@sakilacustomer.org	570
Jaime	Nettles	jaime.nettles@sakilacustomer.org	571
Casey	Mena	casey.mena@sakilacustomer.org	572
Alfredo	Mcadams	alfredo.mcadams@sakilacustomer.org	573
Alberto	Henning	alberto.henning@sakilacustomer.org	574
Dave	Gardiner	dave.gardiner@sakilacustomer.org	575
Ivan	Cromwell	ivan.cromwell@sakilacustomer.org	576
Johnnie	Chisholm	johnnie.chisholm@sakilacustomer.org	577
Sidney	Burleson	sidney.burleson@sakilacustomer.org	578
Byron	Box	byron.box@sakilacustomer.org	579
Julian	Vest	julian.vest@sakilacustomer.org	580
Isaac	Oglesby	isaac.oglesby@sakilacustomer.org	581
Morris	Mccarter	morris.mccarter@sakilacustomer.org	582
Clifton	Malcolm	clifton.malcolm@sakilacustomer.org	583
Willard	Lumpkin	willard.lumpkin@sakilacustomer.org	584
Daryl	Larue	daryl.larue@sakilacustomer.org	585
Ross	Grey	ross.grey@sakilacustomer.org	586
Virgil	Wofford	virgil.wofford@sakilacustomer.org	587
Andy	Vanhorn	andy.vanhorn@sakilacustomer.org	588
Marshall	Thorn	marshall.thorn@sakilacustomer.org	589
Salvador	Teel	salvador.teel@sakilacustomer.org	590
Perry	Swafford	perry.swafford@sakilacustomer.org	591
Kirk	Stclair	kirk.stclair@sakilacustomer.org	592
Sergio	Stanfield	sergio.stanfield@sakilacustomer.org	593
Marion	Ocampo	marion.ocampo@sakilacustomer.org	594
Tracy	Herrmann	tracy.herrmann@sakilacustomer.org	595
Seth	Hannon	seth.hannon@sakilacustomer.org	596
Kent	Arsenault	kent.arsenault@sakilacustomer.org	597
Terrance	Roush	terrance.roush@sakilacustomer.org	598
Rene	Mcalister	rene.mcalister@sakilacustomer.org	599
Eduardo	Hiatt	eduardo.hiatt@sakilacustomer.org	600
Terrence	Gunderson	terrence.gunderson@sakilacustomer.org	601
Enrique	Forsythe	enrique.forsythe@sakilacustomer.org	602
Freddie	Duggan	freddie.duggan@sakilacustomer.org	603
